#################
#               #
#  %    *    *  #
#   ##  ##      #
#        $   *  #
#               #
# ^             #
#################