################################
# % *  *      F        D  ######
#         ## # ##    # #      ##
#   $#       F ##    # #  *   ##
#        D   *       #*#  *   ##
#       ##           #*#      ##
#                    #D#  $    #
#     ^              #*#       #
#       ###     *    # #  *    #
#         *                    #
#            ^                 #
#                * *           #
#                              #
################################